111111111
1000C0001
111111101
110001101
111111101
1000E0001
111111111