111111111
1000C0P01
100100001
110110E01
100011111
10C0000C1
111111111
