111111111
1000C0P01
100100001
110110001
100011111
1000000E1
111111111