111111111
1000C0P01
100000001
110000001
100000001
1000E0001
111111111